{
       "background": "blue",
       "map": [[0, 1, 1, 1, 1, 1, 0, 0],
              [0, 0, 0, 0, 0, 0, 0, 1],
              [0, 0, 0, 0, 0, 0, 0, 1],
              [0, 0, 0, 1, 1, 0, 0, 1],
              [1, 0, 0, 1, 1, 0, 0, 1],
              [1, 0, 0, 0, 0, 0, 0, 0],
              [1, 0, 0, 0, 0, 0, 0, 1],
              [1, 1, 0, 0, 0, 0, 1, 1],
              [1, 1, 0, 0, 0, 0, 1, 1],
              [1, 1, 0, 0, 0, 0, 1, 1],
              [1, 1, 0, 0, 0, 0, 1, 1],
              [1, 1, 0, 0, 0, 0, 1, 1]],
       "gameObjects": [
              {
                     "type": "ball",
                     "x": 0,
                     "y": 0
              },
              {
                     "type": "ball",
                     "x": 4,
                     "y": 1
              }
       ]
}
